NO ./assets/NO.xpm
WE ./assets/WE.xpm
SO ./assets/SO.xpm
EA ./assets/EA.xpm

F 0,90,100
C 225,30,32
C 221,221,221

11111111111111111111111
11000000000000000000001
100000010000000W000001
1000000000000000000001
1000000000000000000001
1000000000000000000001
1000000000000000000001
1000000000000000000001
1000000001010000000001
1000000001010000000001
1000000000000000000001
1000000000000000000001
1000000000000000000001
1000000000000000000001
1000000000000000000001
1000000000000000000001
1000000000000000000001
1000000000000000000001
1000000000000000000001
1000000000000000000001
1000000000000000000001
1000000000000000000001
1000000000000000000001
1000000000000000000001
11111111111111111111101
11111111111111111111111
111
111