NO ./assets/NO.xpm
WE ./assets/WE.xpm
SO ./assets/SO.xpm
EA ./assets/EA.xpm

F 0,90,100
C 200,30,32
C 100,100,100
111111111111111111111111111111111
111000101110100011000111111000011
110111101110101101111011111011101
110111101110100001000011111011101
110111101110101101111010001011101
110111101110101101111011111011101
111000110001100011000111111000011
111111111111111111111111111111111
 11WDDDDDD0DDDDDDDDDDDDDDDDDDDDD1
 1DDDDDDDD0DDDDDDDDDDDDDD0DDDDDD1
 1110DDDDDDDDDDDDDDDDDDDDDDDDDDD1
 101DDDDDD0DDDDDDDDDDDDDD0DDDDDD1
 111000DD0D0DD000D0DDDDD000D0DDD1
 1101DDDDD0DDDDDDDDDDDDDD0DDDDDD1
 1101DDDDDDDDDDDDDDDDDDDDDDDDDDD1
 1111DDDDD0DDDDDDDDDDDDDD0DDDDDD1
 1000DDDDD0DDDDDD0DDDDDDDDDDDDDD1
 1110DDDDD0DDDDD000DDDDDDDDDDDDD1
 1010DDDDDDDDDDDD0DDDDDDDDDDDDDD1
 1101DDDDD0DDDDDDDDDDDDDDDDDDDDD1
 1100DDDDDDDDDDDDDDDDDDDDDDDDDDD1
 1110DDDDD0DDDDDDDDDDDDDDDDDDDDD1
 1010DDDDDDDDDDDDDDDDDDDDDDDDDDD1
 11111010000000000000000000000011
 11010011101110111110101110110011
 10011100110010000011100100100111
 11110100011011011000011111111101
 11000100001001110010010000000111
 11110011101110011011110111100011
 11010010100010101100001100101111
 11010110111010100110111000101001
 11011101100010100011101101101011
 11000001011110100000000101001111
 11010111000100111101110101100011
 11110101101100100111011000111011
 10100100001011111000001110101011
 11110110111010000011100010001011
 11010011101110111110111111111011
 11111111111111111111111111111111