NO ./assets/NO.xpm
WE ./assets/WE.xpm
SO ./assets/SO.xpm
EA ./assets/EA.xpm

F 3,1,43
C 225,30,89

        111111111111111111111111
        100000000110000000000001
        1001000001110000000000001
        10010000000000000000000011
11111111101100000111000000010000111
1000000000110000011101111101111111
11110111111111011100000010001
11111111111111111111111111D111
11111111111111111111111111D11111
10000000000000000000000000000001
10000000000000000000000000000001
1000000000000000N000000000000001
10000000000000000000000000000001
10000000000000000000000000000001
10000000000000000000000000000001
11111111111111111111111111111111
